COR = "countries/Corsica.txt"
MIA = "countries/Miao.txt"
ARC = "countries/Archia.txt"
ATR = "countries/Atorpatkan.txt"
HLI = "countries/Halicarnassus.txt"
RMA = "countries/Rome.txt"
SHD = "countries/Sur-Hadasht.txt"
HRD = "countries/Hordaland.txt"
AKS = "countries/Aqonshiq.txt"
UBO = "countries/Ubon-Baliq.txt"
RMH = "countries/Ramitha-Hadasht.txt"
BLD = "countries/Bulamandugu.txt"
CEP = "countries/Ce.txt"
CAT = "countries/Cait.txt"
DAR = "countries/Dalriata.txt"
ARD = "countries/Ardrhi.txt"
OSR = "countries/Osraige.txt"
JUD = "countries/Judah.txt"
YIS = "countries/Yisrael.txt"
MOA = "countries/Moab.txt"
PHL = "countries/Philistines.txt"
DEA = "countries/De'an.txt"
NNG = "countries/Nanguo.txt"
MID = "countries/Middag.txt"
MNY = "countries/Minyue.txt"
HNA = "countries/Henan.txt"
HUA = "countries/Huainan.txt"
TIS = "countries/Tianshui.txt"
KHM = "countries/Khamag.txt"
BYZ = "countries/Byzantion.txt"
TAH = "countries/Tahiti.txt"
CLC = "countries/Colchis.txt"
ODR = "countries/Odrysia.txt"
HTT = "countries/Hatti.txt"
KLK = "countries/Chalcedon.txt"
URA = "countries/Urartu.txt"
IBE = "countries/Iberia.txt"
ARR = "countries/Caucasian Albania.txt"
ZPH = "countries/Zephyrion.txt"
TRP = "countries/Trapezous.txt"
ANI = "countries/Nineveh.txt"
AAS = "countries/Assur.txt"